WWW3W3WWWWWWWWWWWWWWWWWWWWWWWW
..............................
.............................1
.A...........................1
.............................1
..............................
..............................
..............00000....0000...
...........000000000..000000..
......000000000000000000000000
WWWWWWWWWWWWWWWWWWWWWWWWWWWWWW
