FFFFFFFFFEFFFFFFFEFFFFFFFFFFFC
FFFFFFEFFFFFFFFFFFFFFFFFFFFFBC
FFFFFFFFFFFFFFEFFFFFFFFFFFFFBC
FFFFFFFFFFFFFFFFFFFFEFFFFFFFBC
FFFDFFFFFFFFEFFFFFFFFFFFFFFFBC
FFFFFFFFFFFFFFFFEFFFFFFFFFFFBC
FFFFFFFFFEFFFFFFFFFFFFEFFFFFBC
FFFFFFFFFFFFFFFFFFFFFFFFFFFFBC
FFFFEFFFFFFFFFFFFFFEFFFFFFFFFC
FFFFFFFFFFFFFFFFFFFFFFFFFFFFBC
FFFFFFEFFFFFFFFFFFFFFFFFFFFFBC
