wwwwwwwwwwwwwwwwwwwwwwwwwwwwww
wA......w..............+.....w
w.......w..wwwwwwww..wwww....w
w..ww...w..w......w..w.......w
w..w....w..w......w..w....3..w
w..w....w..w......w..w.......w
w..w....w..wwww...w..wwww....w
w..w....w.....w...w.....w..g.w
w..w....wwww..w...w.....w....w
w.1w....1......+........w....w
w..............2........3w....w
wwwwwwwwwwwwwwwwwwwwwwwwwwwwww
